B_BBB_BG__
__BBG___B_
_BBB_S___B
S_SS___B__
BGS_B_BBB_